NO textures/nnn_letter.xpm
SO textures/sss_letter.xpm
WE textures/www_letter.xpm
F 153,76,0
EA textures/eee_letter.xpm


C 102,178,255


1111    11111111111     11111111111111
1001    10000000001     10000000000001
1001    10110000011     10000000000001
1001    100100000001111100000000111111
100111111011000001110000000000001
100000000011000001110111111111111
11110111111111011100000000001           11111111111
11110111111111011101010010001           10000000001
110000001101110111000000100011          11111111111
100000000111 1100000001100001
10000000000010001010100100N01
1100000111000001111101111000111
11110111 1110101 101111010001
11111111 1111111 111111111111
