NO textures/nnn_letter.xpm
SO textures/sss_letter.xpm
WE textures/www_letter.xpm
F 153,76,0
EA  textures/eee_letter.xpm
C 102,178,255

111111
1000S1
100001
111011
111111
