NO textures/nnn_letter.xpm
SO textures/sss_letter.xpm	
WE textures/www_letter.xpm
EA textures/eee_letter.xpm

F 153,76,0
C 102,178,255

111111
100101
101001
1100N1
111111
