NO ./path_to_the_north_texture.xpm
SO ./path_to_the_south_texture
WE ./path_to_the_west_texture
F 0,0,255
EA ./path_to_the_east_texture
C 225,30,0

1111111
1010101
1000001
1010001
100N001
1111111